 , , , , , , , , , ,    , , , , , , , , , , 
 ,X, ,#, ,O, ,X, ,#,    ,O, ,X, ,#, ,O, ,X, 
 , , , , , , , , , ,p2-blue, , , , , , , , , , 
 ,#, ,O, ,X, ,#, ,O,    ,X, ,#, ,O, ,X, ,#, 
 , , , , , , , , , ,    , , , , , , , , , , 
 ,O, ,X, ,#, ,O, ,X,p1-red,#, ,O, ,X, ,#, ,O, 
 , , , , , , , , , ,    , , , , , , , , , , 
 ,X, ,#, ,O, ,X, ,#,    ,O, ,X, ,#, ,O, ,X, 
 , , , , , , , , , ,p2-blue, , , , , , , , , , 
 ,#, ,O, ,X, ,#, ,O,    ,X, ,#, ,O, ,X, ,#, 
 , , , , , , , , , ,    , , , , , , , , , , 