 , , , , , , , , , , , , , , , , , , , , , 
 , , , , , , , , , , , , , , , , , , , , , 
 , , , , , , , , , , , , , , , , , , , , , 
 , , , , , , , , , , , , , , , , , , , , , 
 , , , , , , , , , , , , , , , , , , , , , 
 , , , ,#,#,#,#,#,#,#,#,X,X,X,X, , , , , , 
 , , , , , , , , , , , , , , , , , , , , , 
 , , , , , , , , , , , , , , , , , , , , , 
 , , , , , , , , , ,brown-2, , , , , , , , , , , 
 , , , , , , , , , , , , , , , , , , , , , 
 , , , , , , , , , , , , , , , , , , , , , 
 , , , , , ,X,X,X,X,#,#,#,#,#,#,#,#, , , , 
 , , , , , , , , , , , , , , , , , , , , , 
 , , , , , , , , , , , , , , , , , , , , , 
 , ,p1-1, , , , , , , , , , , , , , , , , , , 
 , , , , , , , , , , , , , , , , , , , , , 
 , , , , , , , , , , , , , , , , , , , , , 