 , , , , , , , , , , , , , , , , , , , , , 
 , , , , ,grey-2, , , , , , , , , , , , , , , , 
 , , , , , , , , , , , , , , , , , , , , , 
 , , ,#,#,X,X,X,X,X,X,#, , , , , , , , , , 
 , , , , , , , , , , ,#, , , , , , , , , , 
 ,p1-1, , , , , , , , , ,#, , , , , , , , , , 
 , , , , , , , , , , ,#, , , , , , , , , , 
 , , , , , , , , , , ,#, , , , , , , , , , 
 , , , , , , , , , ,#,#, , , , , , , , brown-2, , 
 , , , , , , , , , ,#, , , , , , , , , , , 
 , , , , , , , , , ,#, , , , , , , , , , , 
 , , , , , , , , , ,#, , , , , , , , , , , 
 , , , , , , , , , ,#, , , , , , , , , , , 
 , , , , , , , , , ,#,X,X,X,X,X,X,#,#, , , 
 , , , , , , , , , , , , , , , , , , , , , 
 , , , , , , , , , , , , , , , , , ,grey-2, , , 
 , , , , , , , , , , , , , , , , , , , , , 